 ______________________________________________________________________________________________________________________ 
|HHHHHHHHHHHHHHHHHHHHHHHHHHHHHHHHHHHHHHHHHHHHHHHHHHHHHHHHHHHHHHHHHHH|                                                  |
|HHHHHHHHHHHHHHHHHHHHHHHHHHHHHHHHHHHHHHHHHHHHHHHHHHHHHHHHHHHHHHHHHHH|                                                  |
|HHHHHHHHHHHHHHHHHHHHHHHHHHHHHHHHHHHHHHHHHHHHHHHHHHHHHHHHHHHHHHHHHHH|                                                  |
|HHHHHHHHHHHHHHHHHHHHHHHHHHHHHHHHHHHHHHHHHHHHHHHHHHHHHHHHHHHHHHHHHHH|                                                  |
|HHHHHHHHHHHHHHHHHHHHHHHHHHHHHHHHHHHHHHHHHHHHHHHHHHHHHHHHHHHHHHHHHHH|                                                 H|
|HHHHHHHHHHHHHHHHHHHHHHHHHHHHHHHHHHHHHHHHHHHHHHHHHHHHHHHHHHHHHHHHHHH|                                            HHHHHH|
|HHHHHHHHHHHHHHHHHHHHHHHHHHHHHHHHHHHHHHHHHHHHHHHHHHHHHHHHHHHHHHHHHHH|                                        HHHHHHHHHH|
|HHHHHHHHHHHHHHHHHHHHHHHHHHHHHHHHHHHHHHHHHHHHHHHHHHHHHHHHHHHHHHHHHHH|                                     HHHHHHHHHHHHH|
|HHHHHHHHHHHHHHHHHHHHHHHHHHHHHHHHHHHHHHHHHHHHHHHHHHHHHHHHHHHHHHHHHHH|                                          HHHHHHHH|
|HHHHHHHHHHHHHHHHHHHHHHHHHHHHHHHHHHHHHHHHHHHHHHHHHHHHHHHHHHHHHHHHHHH|                                          HHHHHHHH|
|HHHHHHHHHHHHHHHHHHHHHHHHHHHHHHHHHHHHHHHHHHHHHHHHHHHHHHHHHHHHHHHHHHH|                                       HHHHHHHHHHH|
|                                                                                                                      |
|HHHHHHHHHHHHHHHHHHHHHHHHHHHHHHHHHHHHHHHHHHHHHHHHHHHHHHHHHHHHHHHHHHH|                                                  |
|HHHHHHHHHHHHHHHHHHHHHHHHHHHHHHHHHHHHHHHHHHHHHHHHHHHHHHHHHHHHHHHHHHH|                                                  \
|HHHHHHHHHHHHHHHHHHHHHHHHHHHHHHHHHHHHHHHHHHHHHHHHHHHHHHHHHHHHHHHHHHH|                                                  /
|HHHHHHHHHHHHHHHHHHHHHHHHHHHHHHHHHHHHHHHHHHHHHHHHHHHHHHHHHHHHHHHHHHH|                                                  |
|HHHHHHHHHHHHHHHHHHHHHHHHHHHHHHHHHHHHHHHHHHHHHHHHHHHHHHHHHHHHHHHHHHH|                                                  |
|HHHHHHHHHHHHHHHHHHHHHHHHHHHHHHHHHHHHHHHHHHHHHHHHHHHHHHHHHHHHHHHHHHH|                                                  |
|___________________________________________________________________|                                                  |
|                                                                                                              HHHHHHHH|
|                                                                                          HHHHHHHHHHHHHHHHHHHHHHHHHHHH|
|                                                                                 HHHHHHHHHHHHHHHHHHHHHHHHHHHHHHHHHHHHH|
|HHHHHHHHHHHHHHHHHHHHHHHHHHHHHHHHHHHHH                                                 HHHHHHHHHHHHHHHHHHHHHHHHHHHHHHHH|
|HHHHHHHHHHHHHHHHHHHHHHHHHHHHHHHHHHHHH                                                     HHHHHHHHHHHHHHHHHHHHHHHHHHHH|
|HHHHHHHHHHHHHHHHHHHHHHHHHHHHHHHHHHHH                                                           HHHHHHHHHHHHHHHHHHHHHHH|
|HHHHHHHHHHHHHHHHHHHHHHHHHHHHHHHHHHH                                                             HHHHHHHHHHHHHHHHHHHHHH|
|HHHHHHHHHHHHHHHHHHHHHHHHHHHHHHHHHHHHH                                                           HHHHHHHHHHHHHHHHHHHHHH|
|HHHHHHHHHHHHHHHHHHHHHHHHHHHHHHHHHHHHH                                                               HHHHHHHHHHHHHHHHHH|
|______________________________________________________________________________________________________________________|