 ______________________________________________________________________________________________________________________ 
|HHHHHHHHHHHHHHHHHHHHHHHHHHHHHHHHHHHHHHHHHHHHHHHHHHHH                                                                  |
|HHHHHHHHHHHHHHHHHHHHHHHHHHHHHHHHHHHHHHHHHHHHHHHHHHHHHHHHHHHHHHHH                                                      |
|HHHHHHHHHHHHHHHHHHHHHHHHHHHHHHHHHHHHHHHHHHHHHHHHHHHHHHHHHHHHHHHHHHHHHH                                                |
|HHHHHHHHHHHHHHHHHHHHHHHHHHHHHHHHHHHHHHHHHHHHHHHHHHHHHHHHHHHHHHHH                                                      |
|HHHHHHHHHHHHHHHHHHHHHHHHHHHHHHHHHHHHHHHHHHHHHHHHHHHHHHHHHHH                                                          H|
|HHHHHHHHHHHHHHHHHHHHHHHHHHHHHHHHHHHHHHHHHHHHHHHHHHHHH                                                           HHHHHH|
|HHHHHHHHHHHHHHHHHHHHHHHHHHHHHHHHHHHHHHHHHHHHH                                                               HHHHHHHHHH|
|HHHHHHHHHHHHHHHHHHHHHHHHHHHHHHHHHHHHHHHH                                                                 HHHHHHHHHHHHH|
|HHHHHHHHHHHHHHHHHHHHHHHHHHHHHHHHHHHHHHHHHH                                                                    HHHHHHHH|
|HHHHHHHHHHHHHHHHHHHHHHHHHHHHHHHHHHHHHH                                                                        HHHHHHHH|
|HHHHHHHHHHHHHHHHHHHHHHHHHHHHHHHHHHHH                                                                       HHHHHHHHHHH|
|HHHHHHHHHHHHHHHHHHHHHHHHHHHHHHHHHHHH                                                                                  |
|HHHHHHHHHHHHHHHHHHHHHHHHHH                                                                                            |
|HHHHHHHHHHHHHHHHHHHHHH                                                                                                \
|HHHHHHHHHHHHHHHHHHHHHH                                                                                                /
|HHHHHHHHHHHHHHHHHHHH                                                                        N                         |
|HHHHHHHH                                                                                                              |
|HHH                                                                                                                   |
|                                                                                                                      |
|                                                                                                              HHHHHHHH|
|                                                                                          HHHHHHHHHHHHHHHHHHHHHHHHHHHH|
|                                                                                 HHHHHHHHHHHHHHHHHHHHHHHHHHHHHHHHHHHHH|
|HHHHHHHHHHHHHHHHHHHHHHHHHHHHHHHHHHHHH                                                 HHHHHHHHHHHHHHHHHHHHHHHHHHHHHHHH|
|HHHHHHHHHHHHHHHHHHHHHHHHHHHHHHHHHHHHH                                                     HHHHHHHHHHHHHHHHHHHHHHHHHHHH|
|HHHHHHHHHHHHHHHHHHHHHHHHHHHHHHHHHHHH                                                           HHHHHHHHHHHHHHHHHHHHHHH|
|HHHHHHHHHHHHHHHHHHHHHHHHHHHHHHHHHHH                                                             HHHHHHHHHHHHHHHHHHHHHH|
|HHHHHHHHHHHHHHHHHHHHHHHHHHHHHHHHHHHHH                                                           HHHHHHHHHHHHHHHHHHHHHH|
|HHHHHHHHHHHHHHHHHHHHHHHHHHHHHHHHHHHHH                                                               HHHHHHHHHHHHHHHHHH|
|______________________________________________________________________________________________________________________|