1HHHHHHHHHHHHHHHHHHHHHHHHHHHHHHHHHHHHH_________________________________________________________________________________H
1HHHHHHHHHHHHHHHHHHHHHHHHHHHHHHHHHHHHHHHHHHHHHHHHHHHH___________________________________________________________________
1HHHHHHHHHHHHHHHHHHHHHHHHHHHHHHHHHHHHHHHHHHHHHHHHHHHHHHHHHHHHHHHH_______________________________________________________
1HHHHHHHHHHHHHHHHHHHHHHHHHHHHHHHHHHHHHHHHHHHHHHHHHHHHHHHHHHHHHHHHHHHHHH_________________________________________________
1HHHHHHHHHHHHHHHHHHHHHHHHHHHHHHHHHHHHHHHHHHHHHHHHHHHHHHHHHHHHHHHH_______________________________________________________
1HHHHHHHHHHHHHHHHHHHHHHHHHHHHHHHHHHHHHHHHHHHHHHHHHHHHHHHHHHH__________________________________________________________HH
1HHHHHHHHHHHHHHHHHHHHHHHHHHHHHHHHHHHHHHHHHHHHHHHHHHHHH___________________________________________________________HHHHHHH
1HHHHHHHHHHHHHHHHHHHHHHHHHHHHHHHHHHHHHHHHHHHHH_______________________________________________________________HHHHHHHHHHH
1HHHHHHHHHHHHHHHHHHHHHHHHHHHHHHHHHHHHHHHH_________________________________________________________________HHHHHHHHHHHHHH
1HHHHHHHHHHHHHHHHHHHHHHHHHHHHHHHHHHHHHHHHHH____________________________________________________________________HHHHHHHHH
1HHHHHHHHHHHHHHHHHHHHHHHHHHHHHHHHHHHHHH________________________________________________________________________HHHHHHHHH
1HHHHHHHHHHHHHHHHHHHHHHHHHHHHHHHHHHHH_______________________________________________________________________HHHHHHHHHHHH
1HHHHHHHHHHHHHHHHHHHHHHHHHHHHHHHHHHHH___________________________________________________________________________________
1HHHHHHHHHHHHHHHHHHHHHHHHHH_____________________________________________________________________________________________
1HHHHHHHHHHHHHHHHHHHHHH_________________________________________________________________________________________________
1HHHHHHHHHHHHHHHHHHHHHH_________________________________________________________________________________________________
1HHHHHHHHHHHHHHHHHHHH________________________________________________________________________N__________________________
1HHHHHHHH_______________________________________________________________________________________________________________
1HHH____________________________________________________________________________________________________________________
_______________________________________________________________________________________________________________________H
_______________________________________________________________________________________________________________HHHHHHHHH
___________________________________________________________________________________________HHHHHHHHHHHHHHHHHHHHHHHHHHHHH
__________________________________________________________________________________HHHHHHHHHHHHHHHHHHHHHHHHHHHHHHHHHHHHHH
1HHHHHHHHHHHHHHHHHHHHHHHHHHHHHHHHHHHHH_________________________________________________HHHHHHHHHHHHHHHHHHHHHHHHHHHHHHHHH
1HHHHHHHHHHHHHHHHHHHHHHHHHHHHHHHHHHHHH_____________________________________________________HHHHHHHHHHHHHHHHHHHHHHHHHHHHH
1HHHHHHHHHHHHHHHHHHHHHHHHHHHHHHHHHHHH___________________________________________________________HHHHHHHHHHHHHHHHHHHHHHHH
1HHHHHHHHHHHHHHHHHHHHHHHHHHHHHHHHHHH_____________________________________________________________HHHHHHHHHHHHHHHHHHHHHHH
1HHHHHHHHHHHHHHHHHHHHHHHHHHHHHHHHHHHHH___________________________________________________________HHHHHHHHHHHHHHHHHHHHHHH
1HHHHHHHHHHHHHHHHHHHHHHHHHHHHHHHHHHHHH_______________________________________________________________HHHHHHHHHHHHHHHHHHH
1HHHHHHHHHHHHHHHHHHHHHHHHHHHHHHHHHHHHHHHHHHH_______________________________________________________HHHHHHHHHHHHHHHHHHHHH